Name,Alignment,Intelligence,Strength,Speed,Durability,Power,Combat,Total
Banshee,good,50,10,58,42,60,70,290
Blackout,bad,63,32,45,80,38,65,323
Callisto,bad,63,53,23,42,45,85,311
Doctor Doom,bad,100,32,20,100,93,84,429
Domino,good,63,10,27,28,49,74,251
Elektra,good,63,11,30,28,59,100,291
Franklin Richards,good,1,1,1,1,0,1,5
Nick Fury,good,75,11,23,42,25,100,276
Toxin,good,56,73,70,84,75,70,428
Vision,good,100,72,54,95,76,70,467
Winter Soldier,good,56,32,35,65,60,84,332
